111111111111
1010C01E1001
11000P000C01
1010010C1111
111111111111
